11111111111111
10000000000001
100E00C00C0001
10000000101001
10P000101C1001
11111111111111