11111111111111111
10010000100001001
1000C000E00C01001
10000000101001001
10P00010101001001
11111111111111111