111111111111111111111111111111111111
100000000000000000000011110000000001
1000000000000C0000000000000000000001
1000000C0000000000E00001000000000001
100111110000010000000000000000000001
10001000P000011111100011000000000001
10000100000001C000000000000000000001
100000100000010000000001CC0001100001
1000000100C000100C000001111000001001
10000000000000C000000000000000100011
111111111111111111111111111111111111