111111111111111111111111
100000000000000000000011
1000000000000C0000000001
1000000C0000000000E00001
100111110000010000000001
10001000P000011111100011
10000100000001C000000001
100000100000010000000001
1000000100C000100C000001
10000000000000C000000001
111111111111111111111111