11111111111111
10000000000001
100E00C00C0001
10000000000001
10P000100C0001
11111111111111