11111111111111
10010000100001
100E00C00C0E01
10000000101001
10P000101C1001
11111111111111