11111111111111
10010000100001
10000000E00001
10000000101001
10P00010101001
11111111111111