11111111111111
10010000100001
100E0000000001
10000000101001
10P00010101001
11111111111111