11111111111111
10010000100001
100E00C00C0P01
10000000111001
10P000101C1001
11111111111111